ar-EG: Arabic (Egypt)
ar-SA: Arabic (Saudi Arabia)
ar-AE: Arabic (UAE)
ar-KW: Arabic (Kuwait)
ar-QA: Arabic (Qatar)
ca-ES: Catalan
da-DK: Danish (Denmark)
de-DE: German (Germany)
en-AU: English (Australia)
en-CA: English (Canada)
en-GB: English (United Kingdom)
en-IN: English (India)
en-NZ: English (New Zealand)
en-US: English (United States)
es-ES: Spanish (Spain)
es-MX: Spanish (Mexico)
fi-FI: Finnish (Finland)
fr-CA: French (Canada)
fr-FR: French (France)
gu-IN: Gujarati (Indian)
hi=IN: Hindi (India)
it-IT: Italian (Italy)
ja-JP: Japanese (Japan)
ko-KR: Korean (Korea)
mr-IN: Marathi (India)
nb-NO: Norwegian (Norway)
nl-NL: Dutch (Netherlands)
pl-PL: Polish (Poland)
pt-BR: Portugese (Brazil)
pt-PT: Portugese (Portugal)
ru-RU: Russian (Russia)
sv-SE: Swedish (Sweden)
ta-IN: Tamil (India)
te-IN: Telugu (India)
zh-CN: Chinese (Mandarin, simplified)
zh-HK: Chinese (Cantonese, Traditional)
zh-TW: Chinese (Taiwanese Mandarin)
th-TH: Thai (Thailand)
tr-TR: Turkey
